,PLAYER_ID,PLAYER_NAME,GP,FGA,FGM,STL,FG3M,FTA,FTM,BLK,OREB,AST,DREB,PF,TOV,MIN,FT_MISS,FG_MISS,PER
440,203999,Nikola Jokic,53,921,525,74,86,299,241,39,149,419,581,133,199,1752.7216666666666,58,396,37.42
201,203507,Giannis Antetokounmpo,49,906,496,48,58,545,393,68,94,296,457,156,162,1603.6083333333333,152,410,37.05
290,203954,Joel Embiid,47,905,449,48,65,531,432,66,91,210,433,124,139,1546.0533333333333,99,456,35.63
368,2544,LeBron James,42,886,459,66,116,238,179,41,47,269,288,93,137,1544.0533333333333,59,427,30.76
341,201142,Kevin Durant,36,729,379,28,67,255,228,34,20,207,247,68,107,1313.215,27,350,30.42
232,1629630,Ja Morant,47,955,467,58,69,332,250,19,65,320,212,68,160,1560.92,82,488,29.13
132,201942,DeMar DeRozan,56,1115,581,48,36,447,386,17,47,286,246,122,131,1997.3466666666666,61,534,28.63
543,1629027,Trae Young,54,1102,498,53,158,375,335,5,34,503,175,85,221,1860.5466666666666,40,604,28.6
47,1629634,Brandon Clarke,46,320,208,25,4,95,64,49,98,67,157,83,24,889.735,31,112,28.19
326,1626157,Karl-Anthony Towns,54,905,470,54,114,320,262,61,149,213,374,196,170,1843.9916666666666,58,435,28.11
23,203076,Anthony Davis,37,635,341,45,12,227,161,86,104,107,256,93,76,1297.4566666666667,66,294,27.95
283,202710,Jimmy Butler,41,618,295,72,15,325,288,19,79,242,180,63,88,1406.7816666666668,37,323,27.83
377,1629029,Luka Doncic,45,977,436,51,125,324,238,22,40,406,371,111,198,1593.9016666666666,86,541,27.78
490,203497,Rudy Gobert,45,352,252,33,0,290,199,102,157,53,511,120,83,1447.5716666666667,91,100,27.61
235,201580,JaVale McGee,54,348,226,18,2,108,74,53,123,34,248,133,77,867.1683333333333,34,122,27.42
419,1626149,Montrezl Harrell,51,438,284,21,4,233,166,35,113,104,237,103,58,1268.0116666666668,67,154,26.92
137,1627749,Dejounte Murray,53,952,440,106,68,155,119,17,69,500,376,108,131,1833.4,36,512,26.8
221,1630543,Isaiah Jackson,21,90,50,11,3,43,29,20,25,7,36,39,12,215.38166666666666,14,40,26.8
516,201939,Stephen Curry,55,1069,457,75,253,265,244,22,31,356,260,117,178,1908.3766666666668,21,612,26.23
158,1628378,Donovan Mitchell,47,953,437,76,160,210,183,12,42,244,154,114,139,1571.7066666666667,27,516,26.16
157,1627734,Domantas Sabonis,52,648,377,51,37,269,199,24,171,263,456,163,159,1797.9716666666666,70,271,25.83
581,1626195,Willy Hernangomez,32,199,106,11,3,85,63,11,84,40,132,59,30,511.5283333333333,22,93,25.69
260,1628386,Jarrett Allen,51,503,334,38,1,217,152,70,184,91,376,92,89,1662.9533333333334,65,169,25.41
135,1629028,Deandre Ayton,39,437,278,31,3,106,76,32,99,55,294,90,66,1137.0183333333334,30,159,25.24
253,201935,James Harden,45,718,299,56,107,359,312,31,43,459,316,109,214,1662.4116666666666,47,419,25.0
354,204001,Kristaps Porzingis,34,508,229,25,49,170,147,59,64,69,197,88,53,1001.7433333333333,23,279,24.75
86,101108,Chris Paul,58,667,325,108,60,185,156,18,16,619,243,118,138,1916.16,29,342,24.57
244,1627751,Jakob Poeltl,50,487,302,36,1,139,65,89,196,146,264,151,79,1455.17,74,185,24.4
149,1626164,Devin Booker,53,1100,492,60,137,269,234,21,41,244,232,132,129,1815.9316666666666,35,608,24.29
344,201567,Kevin Love,51,538,228,17,127,160,136,12,58,108,314,60,65,1133.1116666666667,24,310,24.17
212,202355,Hassan Whiteside,47,254,160,14,0,123,81,71,117,19,250,138,41,864.9183333333333,42,94,24.15
294,202685,Jonas Valanciunas,54,696,373,26,47,217,178,49,175,137,452,175,133,1690.4466666666667,39,323,24.12
274,1628369,Jayson Tatum,58,1194,518,57,162,351,297,41,68,243,419,134,167,2093.9133333333334,54,676,23.81
220,1628392,Isaiah Hartenstein,48,243,150,35,4,86,55,55,73,93,141,117,54,785.59,31,93,23.78
361,1630163,LaMelo Ball,54,911,384,84,144,190,163,22,88,406,293,174,173,1762.7366666666667,27,527,23.71
360,200746,LaMarcus Aldridge,40,413,230,13,12,86,74,44,63,35,165,70,40,911.3866666666667,12,183,23.71
588,203897,Zach LaVine,48,870,418,29,137,233,203,18,13,213,220,81,130,1659.9333333333334,30,452,23.61
482,1629057,Robert Williams III,49,298,217,43,0,79,56,105,193,98,282,106,57,1458.8233333333333,23,81,23.5
34,1628389,Bam Adebayo,35,470,246,52,0,209,157,28,99,123,265,107,100,1169.06,52,224,23.42
78,1629646,Charles Bassey,23,47,30,5,0,12,9,17,22,7,40,32,8,167.86,3,17,23.36
322,203994,Jusuf Nurkic,56,600,321,62,15,268,185,34,167,157,452,189,143,1578.485,83,279,23.3
110,1629655,Daniel Gafford,50,281,191,19,0,90,67,76,112,52,187,120,46,1029.465,23,90,23.28
125,1630549,Day'Ron Sharpe,31,143,82,10,1,41,24,15,79,16,74,60,29,378.67,17,61,23.14
90,203991,Clint Capela,51,419,246,35,0,122,57,70,192,70,428,113,31,1430.9316666666666,65,173,23.05
312,201950,Jrue Holiday,47,667,338,69,87,116,88,24,46,309,170,92,127,1552.4833333333333,28,329,22.84
412,203488,Mike Muscala,43,248,113,18,70,57,48,26,21,22,108,58,14,592.52,9,135,22.82
507,1628983,Shai Gilgeous-Alexander,45,834,360,52,69,315,255,36,32,246,181,106,116,1559.6783333333333,60,474,22.6
266,1629637,Jaxson Hayes,48,243,157,18,8,122,94,36,71,24,120,114,35,818.0816666666667,28,86,22.36
291,1628381,John Collins,50,605,325,32,62,160,127,54,90,94,307,153,56,1563.7233333333334,33,280,22.34
107,203081,Damian Lillard,29,552,222,17,92,181,159,11,13,212,107,37,83,1056.19,22,330,22.33
441,202696,Nikola Vucevic,53,856,404,52,80,90,69,63,107,192,512,132,103,1797.9116666666666,21,452,22.13
455,1627783,Pascal Siakam,45,765,375,57,48,235,174,32,92,231,292,154,123,1691.165,61,390,22.06
88,1626174,Christian Wood,55,732,355,42,101,263,157,51,97,121,464,136,105,1696.215,106,377,21.97
448,1630168,Onyeka Okongwu,27,131,95,18,0,60,43,37,61,33,86,86,31,577.09,17,36,21.65
19,203083,Andre Drummond,53,270,144,61,0,97,49,48,149,105,327,131,86,986.9116666666666,48,126,21.62
195,1627780,Gary Payton II,57,264,163,80,36,50,29,18,54,45,142,96,29,947.6233333333333,21,101,21.54
420,1629021,Moritz Wagner,45,238,119,13,41,79,63,10,22,49,88,82,32,564.175,16,119,21.49
460,202331,Paul George,26,556,234,53,70,117,103,10,11,142,174,65,109,923.7716666666666,14,322,21.46
49,1627742,Brandon Ingram,46,834,375,29,66,250,205,22,31,248,230,98,120,1578.77,45,459,21.42
435,1629651,Nic Claxton,26,160,103,13,0,53,30,28,55,21,86,56,18,541.2616666666667,23,57,21.38
269,1627759,Jaylen Brown,48,901,414,50,124,239,185,16,38,156,267,122,137,1644.035,54,487,21.38
117,1629636,Darius Garland,47,766,365,56,121,112,102,5,23,374,133,81,176,1625.8666666666666,10,401,21.31
575,1628976,Wendell Carter Jr.,52,551,283,32,60,160,113,36,110,141,422,135,92,1532.3566666666666,47,268,21.23
349,203114,Khris Middleton,48,721,316,57,109,216,191,13,30,253,234,119,141,1540.82,25,405,21.22
39,1626171,Bobby Portis,51,637,307,39,97,94,71,41,132,66,333,134,74,1467.6116666666667,23,330,21.19
415,1629011,Mitchell Robinson,54,249,189,36,0,131,68,89,206,23,266,147,43,1377.0266666666666,63,60,21.19
384,1627763,Malcolm Brogdon,29,425,190,25,49,122,105,11,24,170,124,58,61,964.8383333333334,17,235,21.12
186,1627832,Fred VanVleet,51,879,366,82,203,175,153,27,39,352,192,120,137,1949.7883333333334,22,513,21.11
45,203078,Bradley Beal,40,771,348,36,63,203,169,15,38,265,151,95,135,1438.95,34,423,21.08
99,1626156,D'Angelo Russell,47,747,311,42,140,176,143,21,17,327,145,102,120,1514.9066666666668,33,436,21.07
166,2730,Dwight Howard,43,138,83,29,6,92,58,28,88,23,156,85,34,631.92,34,55,20.93
447,1630209,Omer Yurtseven,43,212,115,15,1,55,35,18,72,44,180,73,36,606.115,20,97,20.92
478,1626158,Richaun Holmes,41,284,190,17,2,87,67,39,87,46,215,120,55,1012.39,20,94,20.81
530,201152,Thaddeus Young,29,146,83,25,0,26,11,8,47,63,60,42,35,424.675,15,63,20.81
413,1628970,Miles Bridges,59,907,436,60,106,243,194,53,71,215,357,155,118,2133.7033333333334,49,471,20.79
60,203468,CJ McCollum,42,792,357,44,130,96,69,21,42,194,147,87,84,1484.5766666666666,27,435,20.71
258,1628991,Jaren Jackson Jr.,60,824,342,60,103,274,220,132,97,64,268,204,99,1674.0416666666667,54,482,20.65
564,1630169,Tyrese Haliburton,56,654,302,97,119,122,101,35,41,434,180,81,133,1954.54,21,352,20.45
230,1627826,Ivica Zubac,56,324,209,25,0,171,122,53,146,77,303,140,83,1350.4816666666666,49,115,20.42
411,201144,Mike Conley,53,580,254,65,126,119,100,17,34,281,132,99,89,1500.4833333333333,19,326,20.37
528,1626179,Terry Rozier,52,832,359,59,154,127,104,19,39,226,184,84,66,1753.0616666666667,23,473,20.35
272,1629669,Jaylen Nowell,43,271,126,23,37,55,41,6,15,88,68,49,22,628.8166666666667,14,145,20.33
249,1630188,Jalen Smith,34,179,88,9,17,60,46,22,63,12,107,64,28,494.31333333333333,14,91,20.12
83,1628449,Chris Boucher,56,382,178,36,42,144,111,57,118,18,211,120,34,1133.92,33,204,19.97
426,1626167,Myles Turner,42,393,200,28,61,105,79,118,65,44,232,119,54,1234.7283333333332,26,193,19.94
148,1630217,Desmond Bane,57,819,375,66,164,110,100,25,34,140,221,148,92,1720.0683333333334,10,444,19.92
129,201599,DeAndre Jordan,31,88,59,10,0,25,12,25,49,13,120,50,20,399.2083333333333,13,29,19.92
126,1628368,De'Aaron Fox,49,863,401,55,50,283,213,21,22,251,166,141,139,1687.9733333333334,70,462,19.78
554,1626168,Trey Lyles,54,387,177,22,44,178,139,26,61,58,190,92,56,1003.775,39,210,19.71
24,1630162,Anthony Edwards,55,977,421,80,164,226,173,40,49,201,211,125,151,1902.9916666666666,53,556,19.7
450,203490,Otto Porter Jr.,49,327,156,53,70,39,30,24,53,75,205,65,25,1050.4433333333334,9,171,19.59
431,1629675,Naz Reid,58,363,171,25,42,112,83,61,80,52,141,126,58,924.4033333333333,29,192,19.59
538,202699,Tobias Harris,50,746,359,31,59,168,143,32,55,183,307,102,86,1761.6883333333333,25,387,19.57
106,1627745,Damian Jones,38,144,92,11,5,68,50,25,52,42,95,78,37,575.0983333333334,18,52,19.54
205,203476,Gorgui Dieng,37,96,46,10,23,24,17,13,32,29,80,45,20,331.6483333333333,7,50,19.52
93,203469,Cody Zeller,27,90,51,8,0,49,38,6,50,22,75,56,19,354.535,11,39,19.51
245,1628973,Jalen Brunson,59,757,379,52,67,155,126,3,33,316,191,115,103,1896.215,29,378,19.51
518,203500,Steven Adams,57,288,156,49,0,157,87,39,257,185,292,110,91,1491.39,70,132,19.48
211,203084,Harrison Barnes,56,618,289,41,109,315,261,9,62,140,280,71,89,1885.7616666666668,54,329,19.44
430,1630233,Nathan Knight,28,56,27,4,2,45,32,7,22,14,37,29,12,193.56666666666666,13,29,19.43
145,201565,Derrick Rose,26,274,122,22,37,31,30,12,21,103,57,15,39,635.8633333333333,1,152,19.43
154,203473,Dewayne Dedmon,50,224,130,21,16,72,56,27,91,37,216,121,54,820.0916666666667,16,94,19.32
566,1626145,Tyus Jones,54,377,172,51,49,45,39,2,13,225,118,23,37,1111.3683333333333,6,205,19.32
21,203952,Andrew Wiggins,55,764,365,56,124,173,113,39,56,117,176,105,79,1738.7216666666666,60,399,19.3
133,202326,DeMarcus Cousins,25,169,70,21,18,58,45,10,40,27,108,69,34,391.745,13,99,19.17
284,1629111,Jock Landale,36,129,63,7,20,25,21,12,39,32,40,34,23,365.935,4,66,19.17
156,1628415,Dillon Brooks,21,340,145,27,33,72,64,4,17,57,52,69,37,586.56,8,195,19.1
70,1627747,Caris LeVert,43,680,301,41,65,150,114,19,31,188,125,98,81,1337.375,36,379,19.04
17,1630578,Alperen Sengun,51,325,156,41,18,161,113,49,86,129,160,146,106,955.7533333333333,48,169,18.99
436,1630208,Nick Richards,41,81,55,9,0,41,30,19,30,13,50,49,21,343.6766666666667,11,26,18.94
147,1628401,Derrick White,55,627,265,56,89,177,152,47,31,295,165,131,96,1647.025,25,362,18.89
442,1626181,Norman Powell,43,584,267,42,99,218,176,19,20,94,120,100,67,1413.1333333333334,42,317,18.77
22,1629014,Anfernee Simons,54,744,333,29,166,102,91,6,26,208,120,103,105,1583.6633333333334,11,411,18.63
315,203944,Julius Randle,58,980,408,44,93,302,232,34,105,305,485,164,206,2069.391666666667,70,572,18.61
204,202330,Gordon Hayward,48,611,281,46,85,149,126,22,38,173,183,85,80,1547.04,23,330,18.61
210,1628977,Hamidou Diallo,53,486,242,64,23,127,84,17,64,66,194,134,55,1182.4816666666666,43,244,18.6
259,1629020,Jarred Vanderbilt,56,282,166,81,2,97,62,39,174,75,323,142,54,1449.5666666666666,35,116,18.44
333,1626162,Kelly Oubre Jr.,55,745,326,65,151,141,96,23,65,62,162,144,57,1570.1533333333334,45,419,18.43
163,1629234,Drew Eubanks,50,161,85,13,1,79,59,30,66,50,135,63,47,615.5916666666667,20,76,18.36
565,1630178,Tyrese Maxey,52,701,333,37,73,173,151,26,19,238,163,109,61,1848.09,22,368,18.31
9,201143,Al Horford,53,450,202,31,63,79,66,71,82,178,320,99,54,1510.2916666666667,13,248,18.31
167,203939,Dwight Powell,60,263,172,30,13,132,99,25,123,66,144,148,46,1239.94,33,91,18.28
224,1629676,Isaiah Roby,24,134,68,13,14,31,22,11,34,21,59,46,20,386.08666666666664,9,66,18.19
307,1628404,Josh Hart,45,437,224,48,53,173,131,13,56,185,283,131,95,1510.34,42,213,18.16
492,201566,Russell Westbrook,58,923,403,61,59,294,195,15,80,431,367,173,231,2003.0866666666666,99,520,18.16
445,1630167,Obi Toppin,55,303,154,14,21,90,67,23,51,48,144,74,43,826.4116666666666,23,149,18.15
561,1629639,Tyler Herro,47,814,349,32,120,147,127,8,27,183,201,74,129,1534.44,20,465,18.05
347,1626172,Kevon Looney,60,287,159,36,0,103,65,44,162,104,290,162,55,1278.5716666666667,38,128,18.04
180,1630596,Evan Mobley,51,608,305,42,18,188,127,85,95,130,316,103,99,1738.37,61,303,18.04
278,203924,Jerami Grant,35,528,214,34,60,197,166,37,23,85,122,79,68,1124.7283333333332,31,314,18.0
240,1630256,Jae'Sean Tate,57,555,282,55,43,159,114,34,97,177,220,214,109,1563.7733333333333,45,273,17.98
295,1630228,Jonathan Kuminga,48,275,140,19,29,122,82,13,29,34,111,91,46,707.2166666666667,40,135,17.98
357,1628398,Kyle Kuzma,56,771,349,38,105,183,130,47,62,177,429,104,135,1871.4533333333334,53,422,17.96
66,1629661,Cameron Johnson,57,514,237,48,142,85,73,14,35,80,201,97,35,1491.0416666666667,12,277,17.92
301,1629673,Jordan Poole,54,683,300,44,126,169,156,16,25,190,142,140,125,1553.7466666666667,13,383,17.92
556,202684,Tristan Thompson,35,178,92,12,1,76,40,14,81,21,104,60,33,533.495,36,86,17.91
0,203932,Aaron Gordon,54,587,304,39,62,151,111,29,90,142,223,102,97,1715.55,40,283,17.85
526,1629056,Terence Davis,30,267,113,25,49,44,36,11,11,40,83,70,33,536.3116666666666,8,154,17.85
128,1629001,De'Anthony Melton,52,484,187,84,84,84,61,28,52,142,183,87,73,1177.5316666666668,23,297,17.85
396,1630210,Markus Howard,23,74,27,7,23,14,13,0,0,6,6,11,6,135.72666666666666,1,47,17.82
41,202711,Bojan Bogdanovic,57,763,347,26,139,210,183,1,48,97,199,94,98,1766.56,27,416,17.8
417,1628964,Mo Bamba,50,419,196,29,62,50,40,91,103,64,291,129,62,1297.455,10,223,17.8
72,2546,Carmelo Anthony,51,538,236,38,120,119,98,42,43,53,170,115,45,1355.6883333333333,21,302,17.8
94,1630175,Cole Anthony,47,709,283,40,102,188,161,13,28,277,244,127,136,1546.515,27,426,17.68
330,1629640,Keldon Johnson,56,707,331,42,110,162,123,7,59,103,276,105,72,1766.635,39,376,17.64
520,204456,T.J. McConnell,24,181,91,25,7,15,12,9,19,115,61,43,28,580.7283333333334,3,90,17.63
421,1629650,Moses Brown,26,50,27,3,0,43,27,9,16,1,45,28,14,168.72,16,23,17.57
121,1628021,David Nwaba,38,152,71,24,10,57,41,18,36,30,104,48,18,525.0216666666666,16,81,17.57
338,1630231,Kenyon Martin Jr.,56,368,194,24,32,88,57,26,63,72,153,71,42,1118.0933333333332,31,174,17.53
484,201577,Robin Lopez,27,161,92,1,2,40,23,16,54,44,43,52,36,466.47,17,69,17.5
162,203110,Draymond Green,34,201,108,47,12,67,40,41,38,250,219,94,106,1017.9933333333333,27,93,17.46
63,1628997,Caleb Martin,45,322,164,44,44,71,53,21,57,47,119,75,36,1025.61,18,158,17.43
303,1630631,Jose Alvarado,32,143,60,32,18,27,20,5,10,65,36,42,17,407.675,7,83,17.39
196,1629018,Gary Trent Jr.,49,764,328,91,155,113,92,15,15,93,117,103,49,1704.2066666666667,21,436,17.38
584,1630214,Xavier Tillman,39,153,69,41,7,48,31,14,46,40,70,49,26,509.7,17,84,17.35
579,203115,Will Barton,52,681,306,43,117,94,75,27,33,203,225,80,98,1681.2133333333334,19,375,17.33
25,1630264,Anthony Gill,27,56,34,4,7,31,22,6,20,14,22,39,11,234.21833333333333,9,22,17.3
185,1630532,Franz Wagner,61,775,360,53,78,177,150,28,66,181,217,129,99,1947.2966666666666,27,415,17.28
398,1628963,Marvin Bagley III,34,285,134,11,16,58,40,12,76,18,161,56,22,745.5683333333334,18,151,17.2
418,1628420,Monte Morris,53,564,271,36,87,56,48,9,19,229,137,64,55,1591.315,8,293,17.17
433,202357,Nemanja Bjelica,54,268,123,31,41,66,45,18,45,103,164,89,60,821.2516666666667,21,145,17.11
545,1630200,Tre Jones,47,185,92,21,3,46,40,0,18,115,67,42,26,634.7933333333333,6,93,17.1
457,201976,Patrick Beverley,42,325,131,49,60,86,61,38,49,199,136,129,56,1102.12,25,194,17.08
500,1630567,Scottie Barnes,50,612,292,52,41,148,109,39,121,165,249,134,93,1767.5216666666668,39,320,17.05
332,203482,Kelly Olynyk,23,188,74,20,23,53,37,11,34,64,77,56,36,456.695,16,114,17.04
358,200768,Kyle Lowry,47,489,207,56,101,134,114,15,27,368,192,131,138,1612.6416666666667,20,282,17.03
113,201568,Danilo Gallinari,48,391,166,22,77,126,114,9,27,64,188,71,30,1135.46,12,225,16.97
479,201937,Ricky Rubio,34,411,149,49,59,103,88,7,15,225,126,75,90,970.15,15,262,16.93
400,203486,Mason Plumlee,52,240,153,47,0,118,44,32,135,158,284,160,71,1327.0416666666667,74,87,16.93
392,202694,Marcus Morris Sr.,37,493,217,21,76,98,83,11,20,79,156,86,47,1106.5883333333334,15,276,16.91
388,1628370,Malik Monk,53,536,251,38,117,80,62,20,23,133,151,90,72,1432.4016666666666,18,285,16.85
233,203210,JaMychal Green,46,230,105,32,28,65,57,20,47,39,124,104,42,686.4433333333334,8,125,16.84
373,1628366,Lonzo Ball,35,383,162,64,110,28,21,31,35,178,155,85,82,1212.345,7,221,16.83
40,203992,Bogdan Bogdanovic,41,472,205,40,104,56,44,8,15,123,144,85,45,1186.9683333333332,12,267,16.77
589,1630192,Zeke Nnaji,39,176,95,12,37,62,38,13,55,15,89,76,21,651.0583333333333,24,81,16.75
174,202683,Enes Freedom,35,97,51,5,2,28,24,14,61,8,99,42,20,411.36833333333334,4,46,16.7
297,203903,Jordan Clarkson,56,779,314,41,141,114,95,13,42,131,143,104,88,1474.1566666666668,19,465,16.69
367,1628374,Lauri Markkanen,39,447,194,29,79,83,71,22,43,57,165,72,31,1175.3633333333332,12,253,16.62
378,1630568,Luka Garza,29,124,55,8,14,42,27,4,50,16,37,48,17,340.04833333333335,15,69,16.51
280,203087,Jeremy Lamb,41,247,93,23,43,85,72,18,15,58,88,45,26,664.1683333333333,13,154,16.5
410,1628969,Mikal Bridges,60,605,321,71,82,96,80,26,60,133,203,114,47,2088.7766666666666,16,284,16.48
366,1626204,Larry Nance Jr.,37,198,102,38,19,49,32,13,58,73,151,67,27,858.5166666666667,17,96,16.45
91,1629632,Coby White,40,440,199,20,94,75,63,10,13,112,108,95,49,1120.7916666666667,12,241,16.42
444,1628384,OG Anunoby,42,635,277,65,100,107,80,24,66,110,165,124,74,1541.03,27,358,16.42
453,1629023,P.J. Washington,44,347,154,37,79,65,47,42,57,89,190,109,58,1119.2866666666666,18,193,16.4
363,202362,Lance Stephenson,31,228,104,16,17,52,40,3,11,114,83,63,51,570.87,12,124,16.36
397,1627737,Marquese Chriss,23,101,48,11,7,19,12,10,22,12,58,49,17,256.3,7,53,16.34
334,202689,Kemba Walker,37,370,149,26,73,71,60,7,14,131,97,37,48,947.69,11,221,16.33
355,203937,Kyle Anderson,48,330,142,53,26,77,49,27,44,126,204,73,51,1035.6866666666667,28,188,16.33
505,201586,Serge Ibaka,38,209,102,8,26,32,22,27,41,39,127,66,35,617.17,10,107,16.27
548,1630570,Trendon Watford,34,110,64,11,1,41,29,15,26,37,81,61,25,439.6333333333333,12,46,16.25
438,201587,Nicolas Batum,41,269,129,40,79,24,16,31,19,63,162,57,29,1011.0583333333333,8,140,16.23
489,200752,Rudy Gay,35,256,107,20,49,62,49,12,35,39,127,66,30,699.2716666666666,13,149,16.18
37,201933,Blake Griffin,49,288,120,26,31,70,51,13,56,96,154,85,25,879.9716666666667,19,168,16.17
150,1630170,Devin Vassell,52,534,231,51,90,59,48,32,29,90,194,108,38,1353.8516666666667,11,303,16.15
540,1628396,Tony Bradley,45,107,62,10,0,21,14,31,59,22,108,54,28,500.34833333333336,7,45,16.11
494,1630180,Saddiq Bey,60,833,322,53,151,175,146,13,86,168,261,97,77,2007.8783333333333,29,511,16.08
470,1629628,RJ Barrett,49,765,319,26,102,245,169,14,41,127,240,103,97,1624.7933333333333,76,446,16.06
305,1630581,Josh Giddey,54,670,281,51,56,79,56,20,98,345,323,88,171,1700.3516666666667,23,389,16.06
140,203471,Dennis Schroder,53,627,273,44,70,157,134,6,32,237,147,128,117,1547.0933333333332,23,354,16.0
176,201569,Eric Gordon,48,503,243,24,109,120,91,18,14,141,81,53,92,1423.5316666666668,29,260,15.99
514,203915,Spencer Dinwiddie,47,514,198,30,74,150,118,7,37,264,178,113,74,1409.8816666666667,32,316,15.98
202,1629048,Goga Bitadze,36,145,65,13,8,56,34,24,48,27,54,64,29,414.0933333333333,22,80,15.95
379,1628379,Luke Kennard,51,466,210,34,142,53,47,5,12,115,168,82,45,1422.1366666666668,6,256,15.87
348,203920,Khem Birch,32,121,60,24,0,48,36,16,75,37,69,54,18,597.0733333333334,12,61,15.86
10,202692,Alec Burks,59,505,193,63,101,193,159,17,35,156,228,140,58,1577.895,34,312,15.85
506,203552,Seth Curry,49,590,287,37,114,74,65,11,18,197,152,108,93,1696.28,9,303,15.84
69,1626166,Cameron Payne,40,391,158,23,45,66,57,12,16,144,94,75,71,815.1516666666666,9,233,15.78
321,1626159,Justise Winslow,44,215,97,31,13,57,35,23,41,74,138,62,45,689.7133333333334,22,118,15.75
82,1629002,Chimezie Metu,42,328,143,35,40,66,51,24,28,47,218,60,42,930.8366666666667,15,185,15.75
13,1627936,Alex Caruso,28,182,78,54,30,59,48,11,25,109,83,68,40,775.4416666666667,11,104,15.74
493,1630240,Saben Lee,28,122,46,26,12,43,33,10,10,64,56,24,25,407.4916666666667,10,76,15.73
428,1629642,Nassir Little,42,315,145,25,51,94,69,36,58,54,178,82,40,1088.3683333333333,25,170,15.73
144,1627884,Derrick Jones Jr.,35,140,76,16,16,51,42,25,45,19,75,81,18,614.95,9,64,15.68
225,1630191,Isaiah Stewart,52,363,189,17,4,77,53,59,162,55,277,149,65,1348.555,24,174,15.66
456,1626192,Pat Connaughton,54,415,194,51,125,37,30,14,37,66,199,73,31,1457.4516666666666,7,221,15.63
393,203935,Marcus Smart,52,502,208,95,80,140,110,14,34,280,170,126,105,1695.6866666666667,30,294,15.58
264,1629750,Javonte Green,43,223,120,38,22,76,63,24,67,47,121,92,24,1044.5533333333333,13,103,15.56
462,1630194,Paul Reed,25,60,27,19,0,10,4,12,31,10,34,36,8,231.28333333333333,6,33,15.56
141,1628372,Dennis Smith Jr.,37,189,79,45,6,64,42,12,20,132,68,52,51,638.535,22,110,15.55
143,202324,Derrick Favors,39,182,94,17,2,25,16,12,58,25,126,62,9,652.46,9,88,15.52
335,1629026,Kenrich Williams,49,317,146,44,41,55,30,10,75,108,145,81,46,1072.3183333333334,25,171,15.46
89,1629643,Chuma Okeke,50,399,156,74,77,46,39,29,34,80,203,66,39,1201.715,7,243,15.42
18,1629599,Amir Coffey,49,301,139,26,66,83,73,10,22,80,121,63,29,1088.965,10,162,15.42
56,1628981,Bruno Fernando,22,22,11,0,1,8,6,3,10,4,11,8,7,71.66333333333333,2,11,15.38
58,1627741,Buddy Hield,60,782,308,51,201,97,84,18,46,130,206,126,100,1773.0433333333333,13,474,15.34
14,203458,Alex Len,33,155,82,12,6,56,36,25,48,41,105,89,41,556.58,20,73,15.3
177,1629672,Eric Paschall,45,179,87,7,34,66,50,4,25,28,66,43,25,590.6566666666666,16,92,15.27
57,1627854,Bryn Forbes,56,431,190,20,92,64,58,4,6,60,75,70,46,997.8166666666667,6,241,15.24
292,1629723,John Konchar,53,191,95,36,41,37,22,16,62,74,174,70,22,984.5566666666666,15,96,15.22
64,1629629,Cam Reddish,44,381,151,42,63,103,94,13,21,43,71,51,51,917.025,9,230,15.21
476,202704,Reggie Jackson,58,921,364,42,131,121,102,10,29,265,171,113,129,1791.965,19,557,15.19
85,1630537,Chris Duarte,50,575,250,52,87,106,84,10,36,110,169,83,83,1433.36,22,325,15.17
65,1630560,Cam Thomas,49,424,187,27,41,80,65,7,11,65,115,49,41,969.41,15,237,15.16
76,1626224,Cedi Osman,47,424,177,40,95,90,58,8,19,92,88,89,44,1076.9483333333333,32,247,15.15
207,1628960,Grayson Allen,49,461,196,41,124,56,48,15,26,74,140,68,28,1370.8683333333333,8,265,15.12
536,203501,Tim Hardaway Jr.,42,530,209,38,102,103,78,6,13,92,143,74,34,1245.01,25,321,15.09
317,1630551,Justin Champagnie,32,61,29,7,9,9,9,4,37,9,29,32,7,260.33,0,32,15.06
62,1630595,Cade Cunningham,46,703,278,57,90,103,88,31,44,236,210,140,160,1458.5733333333333,15,425,15.06
374,101150,Lou Williams,41,248,97,20,30,56,50,3,12,81,53,38,33,598.2833333333333,6,151,15.06
304,1630528,Josh Christopher,51,314,140,42,39,66,51,7,37,88,72,56,71,839.0566666666666,15,174,15.05
175,202339,Eric Bledsoe,54,468,197,69,51,117,89,19,28,225,154,85,116,1360.6166666666666,28,271,15.04
248,1629667,Jalen McDaniels,39,197,97,20,32,46,31,16,29,43,107,70,30,685.365,15,100,15.04
208,1630535,Greg Brown III,29,87,38,10,5,32,20,12,19,8,38,32,12,245.89,12,49,15.02
20,2738,Andre Iguodala,26,102,40,22,14,16,13,21,19,99,67,25,23,518.39,3,62,15.01
161,203926,Doug McDermott,44,421,198,11,100,38,29,4,17,52,92,68,34,1080.9466666666667,9,223,14.98
525,1629611,Terance Mann,61,525,255,45,59,109,81,8,79,146,243,133,61,1770.615,28,270,14.97
138,1626153,Delon Wright,54,192,85,55,29,42,35,10,35,131,119,40,34,978.9916666666667,7,107,14.92
376,1629652,Luguentz Dort,51,726,293,46,130,191,161,18,38,88,174,149,88,1665.3533333333332,30,433,14.92
92,1628998,Cody Martin,50,322,147,65,50,82,55,25,61,130,147,85,46,1346.63,27,175,14.85
179,203095,Evan Fournier,58,719,303,55,173,83,60,16,32,108,139,124,80,1717.1066666666666,23,416,14.69
405,1629622,Max Strus,48,401,175,16,123,43,33,10,19,61,131,81,37,1126.595,10,226,14.68
346,1629645,Kevin Porter Jr.,40,471,186,48,91,127,77,10,30,242,129,100,137,1194.185,50,285,14.62
553,203504,Trey Burke,32,171,71,10,23,17,16,0,3,46,25,31,21,346.21166666666664,1,100,14.6
2,1628988,Aaron Holiday,45,232,114,26,29,35,28,9,10,91,65,66,44,727.305,7,118,14.57
55,1628971,Bruce Brown,51,288,139,53,14,63,46,27,64,71,158,120,33,1098.7333333333333,17,149,14.57
498,1630572,Sandro Mamukelashvili,34,85,39,7,15,12,9,7,28,16,32,20,10,314.635,3,46,14.55
192,1629726,Garrison Mathews,42,330,137,30,101,132,107,14,25,43,116,120,29,1146.985,25,193,14.53
512,1630219,Skylar Mays,23,61,31,7,8,9,8,0,5,16,20,8,10,206.90333333333334,1,30,14.51
372,1629022,Lonnie Walker IV,55,587,234,35,77,105,83,17,15,124,128,82,61,1265.6316666666667,22,353,14.48
276,201145,Jeff Green,55,405,205,17,43,139,115,21,30,69,143,116,52,1349.3066666666666,24,200,14.47
261,1629633,Jarrett Culver,27,96,40,15,10,23,12,4,10,26,29,30,13,248.35166666666666,11,56,14.37
130,1627761,DeAndre' Bembry,48,213,121,47,15,35,21,25,38,60,114,104,30,949.025,14,92,14.36
406,1628467,Maxi Kleber,43,267,114,23,72,48,37,46,54,50,200,98,32,1085.9983333333332,11,153,14.24
459,201988,Patty Mills,59,653,274,44,186,51,42,16,15,153,113,86,58,1831.3133333333333,9,379,14.23
153,1628984,Devonte' Graham,56,658,237,51,155,112,95,8,27,246,115,80,86,1714.2266666666667,17,421,14.19
328,1628966,Keita Bates-Diop,46,196,99,23,14,46,33,14,47,27,130,49,33,745.5516666666666,13,97,14.18
310,1626196,Josh Richardson,45,347,153,34,63,71,61,24,26,68,99,82,39,1101.0266666666666,10,194,14.13
228,202397,Ish Smith,42,228,98,25,12,20,12,12,16,124,53,46,43,620.2866666666666,8,130,14.13
215,1630529,Herbert Jones,57,414,202,84,38,112,96,49,76,119,147,177,71,1709.1216666666667,16,212,14.06
473,203526,Raul Neto,50,340,157,40,26,83,62,1,11,145,89,80,61,1031.8766666666668,21,183,14.0
306,1630182,Josh Green,45,155,78,29,12,35,25,9,31,58,66,76,20,644.8033333333333,10,77,13.96
299,1629162,Jordan McLaughlin,43,125,47,29,10,31,23,4,10,116,48,25,23,544.8483333333334,8,78,13.92
486,203585,Rodney McGruder,35,131,61,14,34,14,10,4,18,30,50,35,14,480.55833333333334,4,70,13.9
181,1630267,Facundo Campazzo,55,275,104,58,57,72,58,21,20,201,84,112,63,1097.6016666666667,14,171,13.88
139,1630166,Deni Avdija,59,382,170,47,53,90,69,35,38,97,266,137,52,1395.9633333333334,21,212,13.87
97,202709,Cory Joseph,49,308,140,32,50,83,71,14,22,189,106,107,71,1204.7683333333334,12,168,13.86
116,1629647,Darius Bazley,55,498,198,46,56,124,86,60,63,72,301,53,72,1507.8183333333334,38,300,13.83
108,1627814,Damion Lee,48,305,138,32,57,48,41,5,19,46,132,67,30,976.175,7,167,13.8
508,1629003,Shake Milton,32,286,118,22,25,56,49,12,19,91,79,65,38,766.1516666666666,7,168,13.78
452,200782,P.J. Tucker,53,336,168,42,74,54,39,12,77,112,213,127,53,1520.98,15,168,13.76
124,1628432,Davon Reed,30,95,45,17,23,5,4,3,10,29,64,40,8,401.4116666666667,1,50,13.75
313,1629308,Juan Toscano-Anderson,57,206,101,40,23,57,34,15,26,108,126,91,61,828.6466666666666,23,105,13.75
558,1629660,Ty Jerome,48,328,124,30,54,47,38,5,19,109,59,73,37,801.0916666666667,9,204,13.74
386,1627736,Malik Beasley,60,679,257,30,175,42,32,9,23,86,154,71,38,1513.495,10,422,13.71
449,1629052,Oshae Brissett,48,306,123,29,44,94,59,21,75,40,160,72,37,989.6633333333333,35,183,13.71
112,1628464,Daniel Theis,29,186,90,13,24,40,27,21,32,22,112,69,31,625.3716666666667,13,96,13.67
206,1629684,Grant Williams,57,300,148,29,87,55,50,41,42,64,142,130,42,1333.6866666666667,5,152,13.59
342,1628989,Kevin Huerter,52,513,236,32,99,37,30,18,23,144,142,120,67,1515.345,7,277,13.56
464,1630202,Payton Pritchard,51,240,94,10,53,14,14,4,16,93,64,44,33,643.9016666666666,0,146,13.52
251,1630547,James Bouknight,28,136,48,7,17,31,27,1,21,23,27,28,13,295.74333333333334,4,88,13.5
461,200794,Paul Millsap,27,97,37,5,8,23,16,11,34,26,64,55,13,302.185,7,60,13.5
189,1629216,Gabe Vincent,51,396,167,49,93,45,37,12,19,172,84,128,78,1225.7916666666667,8,229,13.39
256,1630215,Jared Butler,28,88,36,9,17,12,7,7,3,34,20,28,22,213.38833333333332,5,52,13.34
524,1627752,Taurean Prince,49,226,101,27,53,37,28,13,18,44,95,70,35,764.0666666666667,9,125,13.29
32,1630245,Ayo Dosunmu,55,342,179,38,52,62,42,23,19,169,138,125,68,1432.645,20,163,13.28
337,203484,Kentavious Caldwell-Pope,56,573,236,61,112,85,77,20,28,97,162,95,66,1660.1633333333334,8,337,13.27
217,1630193,Immanuel Quickley,56,472,174,33,89,93,85,3,20,166,109,127,71,1187.3333333333333,8,298,13.25
466,1630173,Precious Achiuwa,49,358,151,26,18,83,47,29,106,55,230,96,49,1130.6566666666668,36,207,13.23
437,1629638,Nickeil Alexander-Walker,52,633,237,41,95,97,70,19,36,139,129,88,85,1322.1533333333334,27,396,13.22
43,1630538,Bones Hyland,47,378,138,23,80,60,52,13,8,96,120,99,58,846.6266666666667,8,240,13.22
239,203109,Jae Crowder,50,387,156,66,88,67,54,22,23,80,242,120,40,1409.0183333333334,13,231,13.21
300,1629670,Jordan Nwora,46,361,148,23,67,23,18,13,31,46,139,57,44,904.47,5,213,13.08
182,1628402,Frank Jackson,43,402,165,22,76,78,62,9,14,41,55,75,33,968.3916666666667,16,237,13.07
46,1630527,Brandon Boston Jr.,41,264,98,22,28,59,50,11,13,36,81,35,26,620.7433333333333,9,166,13.03
194,203914,Gary Harris,53,495,218,48,101,82,70,8,33,100,79,101,55,1556.8366666666666,12,277,13.02
35,203463,Ben McLemore,43,331,129,18,96,37,29,5,11,38,57,62,29,805.0816666666667,8,202,12.99
527,203082,Terrence Ross,52,473,192,24,68,113,98,12,16,102,119,59,68,1254.5616666666667,15,281,12.99
467,1629656,Quentin Grimes,40,209,88,26,66,17,11,10,22,38,55,60,25,696.515,6,121,12.97
188,1627788,Furkan Korkmaz,52,414,164,31,69,76,62,7,17,117,139,52,43,1239.6083333333333,14,250,12.9
488,1626220,Royce O'Neale,55,305,150,72,83,46,37,26,43,137,228,131,53,1726.95,9,155,12.88
549,1630235,Trent Forrest,47,111,60,26,4,36,29,3,18,73,63,36,41,578.2016666666667,7,51,12.86
160,1627827,Dorian Finney-Smith,59,494,219,70,112,66,45,29,92,111,190,138,64,1934.2716666666668,21,275,12.85
427,1630230,Naji Marshall,33,114,42,17,10,37,31,4,16,26,51,31,25,322.0933333333333,6,72,12.75
542,1628470,Torrey Craig,56,309,139,28,50,40,29,25,65,64,159,104,44,1137.0083333333334,11,170,12.7
279,1630526,Jeremiah Robinson-Earl,44,292,117,27,50,42,30,15,71,44,183,74,35,1013.5583333333333,12,175,12.66
434,203457,Nerlens Noel,25,60,32,30,0,30,21,31,48,23,93,67,20,561.97,9,28,12.64
193,1629109,Gary Clark,28,67,24,10,21,8,6,7,16,11,55,16,6,296.37166666666667,2,43,12.61
197,201588,George Hill,41,234,102,33,37,50,48,6,35,101,97,57,35,1043.53,2,132,12.61
246,1630224,Jalen Green,44,556,218,30,87,156,127,8,16,102,123,68,97,1337.88,29,338,12.6
122,1630558,Davion Mitchell,54,567,229,39,75,44,25,17,30,186,95,101,64,1406.0966666666666,19,338,12.59
523,1629659,Talen Horton-Tucker,43,375,156,40,37,83,66,24,28,113,116,109,63,1115.1066666666666,17,219,12.59
165,1629130,Duncan Robinson,57,566,223,35,172,48,40,11,20,90,150,152,49,1552.635,8,343,12.56
481,203496,Robert Covington,56,383,151,85,88,49,40,71,51,77,260,153,66,1587.6233333333332,9,232,12.47
12,1630197,Aleksej Pokusevski,44,265,106,23,32,18,11,25,43,52,147,53,52,733.7466666666667,7,159,12.35
199,1627777,Georges Niang,55,420,181,21,107,51,44,10,21,83,126,144,46,1278.1983333333333,7,239,12.34
115,1627863,Danuel House Jr.,27,122,48,11,23,37,30,9,9,31,56,28,23,418.0233333333333,7,74,12.33
254,201949,James Johnson,44,240,113,22,15,40,20,16,41,91,115,111,34,857.9833333333333,20,127,12.32
134,1629731,Dean Wade,44,192,88,25,48,29,19,5,28,50,109,74,16,854.73,10,104,12.29
352,1630184,Kira Lewis Jr.,24,146,59,11,13,12,10,1,9,49,30,17,26,341.14,2,87,12.29
96,1630557,Corey Kispert,54,314,136,20,60,45,40,14,38,52,99,55,33,1083.0233333333333,5,178,12.22
362,1630205,Lamar Stevens,42,177,84,20,13,40,25,9,29,25,62,60,22,593.1533333333333,15,93,12.21
324,1629644,KZ Okpala,21,69,30,4,9,11,8,7,11,14,30,25,5,244.07166666666666,3,39,12.2
546,1630544,Tre Mann,47,403,156,36,66,60,45,9,14,56,95,81,37,963.0766666666667,15,247,12.19
100,201571,D.J. Augustin,34,136,55,10,39,38,33,0,7,74,34,17,45,509.77666666666664,5,81,12.12
364,1629013,Landry Shamet,47,307,113,21,75,56,48,4,11,73,80,55,25,928.285,8,194,12.08
318,203200,Justin Holiday,54,505,206,40,139,45,38,22,22,102,122,117,56,1572.95,7,299,12.08
127,1629631,De'Andre Hunter,31,328,145,19,42,84,61,11,16,37,87,93,41,886.1566666666666,23,183,12.07
472,200765,Rajon Rondo,32,156,59,26,25,23,17,5,13,137,83,48,62,593.8966666666666,6,97,12.04
29,1630559,Austin Reaves,40,172,84,12,31,58,48,12,23,53,80,57,21,864.6916666666667,10,88,11.96
308,1628367,Josh Jackson,41,254,103,21,30,56,40,19,17,49,106,72,39,712.0316666666666,16,151,11.94
469,1630181,R.J. Hampton,43,287,110,29,40,85,52,10,14,106,113,62,58,838.3883333333333,33,177,11.94
522,201959,Taj Gibson,39,114,60,16,8,33,25,32,64,25,111,108,23,711.825,8,54,11.93
401,1629680,Matisse Thybulle,44,207,102,80,31,25,18,47,26,52,78,98,30,1156.59,7,105,11.91
4,1630598,Aaron Wiggins,36,207,97,25,27,51,36,9,32,38,94,71,29,814.6966666666667,15,110,11.88
585,1629139,Yuta Watanabe,26,107,43,7,22,34,20,12,15,16,57,33,16,368.71166666666664,14,64,11.88
237,1630183,Jaden McDaniels,58,457,204,47,60,59,47,40,68,68,178,189,61,1508.9366666666667,12,253,11.85
219,1630171,Isaac Okoro,44,299,140,35,38,102,78,14,46,80,93,116,44,1267.46,24,159,11.8
329,1629103,Kelan Martin,27,168,70,13,22,13,9,9,16,21,37,36,14,444.035,4,98,11.78
286,204060,Joe Ingles,45,285,115,23,78,22,17,5,12,158,119,82,46,1122.135,5,170,11.76
383,1630201,Malachi Flynn,35,110,40,14,16,12,7,3,7,41,33,33,10,317.445,5,70,11.64
515,1626169,Stanley Johnson,25,125,59,17,16,31,21,10,16,35,62,68,13,541.5283333333333,10,66,11.61
519,1629004,Svi Mykhailiuk,44,210,84,24,36,32,27,4,20,40,71,48,28,658.5083333333333,5,126,11.6
123,202722,Davis Bertans,37,195,71,12,55,31,29,7,7,18,62,59,14,550.1433333333333,2,124,11.58
250,1630591,Jalen Suggs,40,474,173,50,37,145,112,16,25,170,122,123,124,1114.2366666666667,33,301,11.45
59,1629604,CJ Elleby,36,148,57,18,18,30,24,7,32,41,75,60,18,552.0666666666667,6,91,11.39
159,1628978,Donte DiVincenzo,21,153,50,18,27,35,31,3,20,45,55,30,33,438.2316666666667,4,103,11.35
475,203493,Reggie Bullock,50,343,142,27,96,35,30,6,21,53,146,71,26,1275.595,5,201,11.35
343,1628995,Kevin Knox II,22,62,22,3,11,14,10,1,11,8,24,12,7,174.27333333333334,4,40,11.24
184,1628373,Frank Ntilikina,47,190,72,24,34,24,23,6,7,54,56,51,26,589.0816666666667,1,118,11.2
105,1630625,Dalano Banton,48,168,69,24,11,34,21,8,31,75,73,57,47,567.2983333333333,13,99,11.15
168,1629685,Dylan Windler,37,77,33,9,21,9,7,2,14,25,48,37,13,344.2633333333333,2,44,11.14
164,1630613,Duane Washington Jr.,29,245,92,14,43,29,22,1,2,56,49,39,30,565.065,7,153,11.1
403,1629744,Matt Thomas,35,126,50,8,33,20,16,3,3,20,45,18,8,448.09,4,76,11.1
557,1628972,Troy Brown Jr.,49,214,86,28,35,25,19,4,35,55,138,55,22,884.945,6,128,11.07
531,203648,Thanasis Antetokounmpo,37,86,41,13,1,24,15,9,31,19,47,57,20,358.4316666666667,9,45,10.86
114,201980,Danny Green,41,228,91,41,72,10,9,29,19,41,80,69,35,942.525,1,137,10.82
487,1629641,Romeo Langford,44,184,79,21,29,34,20,16,30,19,74,46,16,728.3416666666667,14,105,10.79
517,1628425,Sterling Brown,38,128,51,12,27,11,10,5,22,30,106,44,21,523.31,1,77,10.75
27,1629717,Armoni Brooks,41,251,87,21,64,19,16,8,12,49,69,60,23,689.9216666666666,3,164,10.74
555,1630530,Trey Murphy III,42,149,50,12,36,28,24,6,28,20,61,39,12,520.545,4,99,10.71
573,201961,Wayne Ellington,35,186,73,19,65,5,4,3,9,24,51,35,15,661.045,1,113,10.65
351,1629681,Killian Tillie,32,116,42,23,26,8,5,14,20,20,35,53,11,426.94166666666666,3,74,10.55
537,1627789,Timothe Luwawu-Cabarrot,36,130,50,13,32,20,17,4,9,26,40,46,13,451.89666666666665,3,80,10.54
170,203901,Elfrid Payton,39,146,57,19,4,28,11,4,20,85,56,35,39,457.37833333333333,17,89,10.54
590,1630533,Ziaire Williams,41,272,122,23,45,29,23,7,14,36,61,83,25,888.075,6,150,10.5
191,202066,Garrett Temple,55,280,106,41,55,41,28,23,29,71,110,80,40,1053.8083333333334,13,174,10.42
7,1629678,Admiral Schofield,25,68,32,3,14,7,5,4,9,16,40,32,13,271.6483333333333,2,36,10.38
216,1629649,Ignas Brazdeikis,28,78,28,7,11,15,12,1,11,21,25,25,8,250.62,3,50,10.37
499,1630583,Santi Aldama,27,97,37,2,4,20,12,7,23,14,41,27,9,276.64,8,60,10.33
422,1630541,Moses Moody,35,105,39,3,20,21,17,6,9,11,39,24,7,333.7366666666667,4,66,10.28
350,1630165,Killian Hayes,48,303,109,50,31,51,41,25,23,196,115,128,82,1166.3866666666668,10,194,9.89
311,1630563,Joshua Primo,30,141,52,11,24,25,19,15,18,42,34,36,28,476.15166666666664,6,89,9.88
142,1627756,Denzel Valentine,24,66,25,8,19,0,0,0,9,11,33,20,12,221.99666666666667,0,41,9.84
340,1630556,Kessler Edwards,29,184,75,22,33,12,10,17,31,20,93,58,30,708.6916666666667,2,109,9.63
222,1630198,Isaiah Joe,42,146,53,11,38,21,20,2,5,29,42,39,15,506.5183333333333,1,93,9.49
404,203090,Maurice Harkless,42,178,81,27,31,28,20,23,12,22,94,71,29,828.5883333333334,8,97,9.33
31,202340,Avery Bradley,49,299,123,46,67,14,12,9,27,41,86,94,33,1164.8116666666667,2,176,9.31
44,202954,Brad Wanamaker,23,77,28,7,4,25,23,6,6,55,33,45,23,319.62,2,49,9.25
30,203085,Austin Rivers,45,243,101,34,54,27,19,4,15,52,63,74,39,949.9666666666667,8,142,9.02
229,1630688,Ish Wainright,31,59,22,9,10,7,3,5,19,10,18,33,10,221.80833333333334,4,37,8.79
532,1630177,Theo Maledon,33,143,47,14,18,44,37,5,10,39,45,35,28,463.9266666666667,7,96,8.72
309,1629006,Josh Okogie,34,75,26,17,10,39,25,10,25,19,37,40,19,412.335,14,49,8.49
243,1627774,Jake Layman,24,51,19,6,4,8,6,4,4,7,20,9,7,173.04833333333335,2,32,8.48
336,203145,Kent Bazemore,32,121,40,21,24,17,13,6,10,29,45,56,11,461.78,4,81,8.46
282,1628975,Jevon Carter,46,174,58,14,42,10,7,10,9,46,58,45,26,551.9983333333333,3,116,8.43
552,2772,Trevor Ariza,21,79,27,11,20,14,7,4,6,23,65,18,10,403.87,7,52,8.4
345,1630698,Kevin Pangos,24,46,15,3,6,4,3,0,2,30,9,11,7,166.01333333333332,1,31,8.14
539,203107,Tomas Satoransky,33,107,32,14,5,29,22,1,18,76,47,33,23,489.98333333333335,7,75,8.12
578,202083,Wesley Matthews,30,133,54,13,33,10,6,5,15,20,40,58,11,575.76,4,79,8.04
485,203918,Rodney Hood,41,132,46,12,24,14,13,4,13,31,55,27,7,595.08,1,86,8.01
3,1630174,Aaron Nesmith,42,146,56,12,23,19,16,4,12,15,58,53,25,448.47,3,90,7.92
541,203503,Tony Snell,42,119,48,10,33,3,3,7,13,23,72,50,15,624.86,0,71,7.52
414,1630540,Miles McBride,22,59,15,8,5,4,3,1,2,24,14,15,3,153.35,1,44,7.25
314,1627823,Juancho Hernangomez,25,34,8,5,4,13,9,3,13,6,27,8,9,151.53833333333333,4,26,7.23
84,1629185,Chris Chiozza,26,65,19,9,16,1,1,0,8,47,22,24,22,279.2133333333333,0,46,6.66
504,1628400,Semi Ojeleye,22,77,20,5,12,16,12,5,26,5,34,26,7,320.97,4,57,5.99
320,1629620,Justin Robinson,25,93,28,9,18,8,4,1,4,32,17,27,17,303.72833333333335,4,65,5.13
369,1630195,Leandro Bolmaro,25,32,9,5,2,9,8,0,15,11,20,21,12,187.745,1,23,4.56
